1111111111111111111111111111111111
1E000X0000000X0C0000XC000000000001
1010010100100000101001000000010101
101001001010101000100100X000010101
1P00000X0C00C000000X000000000000C1
1111111111111111111111111111111111
